NO ./path_to_the_north_texture
WE ./path_to_the_west_texture
SO ./path_to_the_south_texture
EA ./path_to_the_east_texture

F 225,250,0
C 225,100,0


  11111111111111111111 1111
  1000000000110000000010001
  1011000001110000000000001
  100100000000010000000000111111
111111111011000001110000000000001
100000000011001011110111111111111
11110111111111 1 100000010001
11110111111111 11101010010001
11000000110101111100000010001
10000000000000001100000010001
10000000000000001101010010001
11000001110101011111011110N01
11110111 1110101 101111010001
11111111 1111111 111111111111   1111111
                                1110S01
                                111111

